##xxxxx##
##@@####x
##x#x#x##
##@###@##
#x#x#x#x#
##xxxxx##
#@@##@###
#x#x#x#x#
##xxxxx##
##x#x#x##
#B#####@@
x#x#xxxxx
##@###@##
##xxxxx#@
##x#x#x##
#x#x#x#x#
#@@#####@
##xxxxx##
#########